ABB	 ABB AB, P.O. Box 1005, SE-61129 Nyköping, Nyköping,Sweden
ABN	 ABN Braun AG, Platenstraße 59, 90441 Nürnberg, Germany
ACA	 Acean, Zi de la Liane, BP 439, 62206 Boulogne Sur Mer Cedex, FRANCE
ACB	 AcBel Polytech Inc., No. 159, Sec. 3, Danjin Rd., Tamsui Dist.,New Taipei, Taiwan (R.O.C.)
ACE	 Actaris, France. (Electricity)
ACG	 Actaris, France. (Gas)
ACW	 Actaris, France. (Water and Heat)
ADD	 "ADD-Production" S.R.L., 36, Dragomirna str., MD-2008, Chisinau, Republic of Moldova
ADX	 ADD-Production S.R.L., 36, Dragomirna str., MD-2008, Chisinau, Republic of Moldova
ADN	 Aidon Oy, 40101 Jyvaskyla, Finland
ADU	 Adunos GmbH, Am Schlangengraben 16, D-13597 Berlin, Germany
AEC	 Advance Electronics Company, Riyadh, Saudi Arabia
AEE	 Atlas Electronics, 17530 Surdulica, Serbia and Montenegro
AEG	 AEG
AEL	 Kohler, Turkey
AEM	 S.C. AEM S.A. Romania
AER	 Aerzener Maschinenfabrik GmbH, Reherweg 28, 31855 Aerzen, Germany
AFX	 Alflex Products, Zoetermeer, Holland
AGE	 AccessGate AB, Rissneleden 144, 174 57 Sundbyberg, Sweden
ALF	 Alfatech - Elektromed Elektronik, Ankara, Turkey
ALG	 Algodue Elettronica srl, Via Passerina, 3/A, Fontaneto D\'Agogna, Italy
ALT	 Amplitec GmbH, Gootkoppel 28, Reinfeld, Germany
AMB	 Amber wireless GmbH, Hawstra e 2a, 54290 Trier, Germany
AME	 AVON METERS PRIVATE LIMITED, D-15/16/17, INDUSTRIAL FOCAL POINT, DERABASSI,PUNJAB-140507INDIA
AMH	 AMiHo Ltd, 1010 Cambourne Business Park, Cambourne, Cambridge, CB1 9AY, UK
AMI	 AMI Tech(I) Pvt. Ltd, #205&206,NSIC-EMDBP, Kamalanagar, ECIL PO, Hyderabad- 500062, India
AML	 Eon Electric Ltd., C-124, Hosierry Complex, Noida Phase II, NOIDA, INDIA
AMP	 Ampy Automation Digilog Ltd
AMS	 Zhejiang Chaoyi Electronic Technology Co. Ltd., Zhejiang, China.
AMT	 Aquametro
AMX	 APATOR METRIX SA, Piaskowa 3, 83-110 Tczew, Poland
ANA	 Anacle Systems PTE LTD, 1A International Business Park #05-02, Singapore
AND	 ANDIS sro, Bratislava, Slovakia
AON	 ASTRON d.o.o., Cesta XIV. divizije 51, Maribor, Slovenia
APA	 APATOR SA (Electricity), Zolkiewskiego 21/29, 87-100, Torun,Poland
APR	 Apronecs Ltd, Gabrovo, Bulgaria
APS	 Apsis Kontrol Sistemleri, Turkey
APT	 Apator SA (Gas, water and heat), ó kiewskiego 21/29, Toru , Poland
APX	 Amplex A/S, Aarhus C, Denmark
AQM	 Aquametro AG, Ringstrasse 75, Therwil, Switzerland
AQT	 AQUATHERM P.P.H, Kujawinski, Lomianki, Poland
ARC	 Arcelik AS., Istanbul, Turkey
ARF	 ADEUNIS_RF, 283 rue Louis NEEL, CROLLES 38920, France
ARM	 arivus metering GmbH, Mielestr. 2, 14542 Werder (Havel), Germany
ARS	 ADD - Bulgaria Ltd, Bul. \"6 septemvri\" 252 Et.7, Plovdiv, Bulgaria
ART	 Electrotécnica Arteche Smart Grid, Derio Bidea 28, Zabalondo Industrialdea, 48100 Mungia, Bizkaia. Spain
ASR	 Erelsan Elektrik ve Elektronik, Malzeme, Istanbul, Turkey
AST	 ASTINCO Inc., 114 Anderson Ave. Suite 7A, ON, L6E1A5, Markham, Canada
ATF	 AKTIF Otomasyon ve GS ve Tic, Turkey
ATI	 ANALOGICS TECH INDIA LIMITED, Plot No.9/10, Road No.6, Nacharam Industrial Estate, HYDERABAD, INDIA
ATL	 Atlas Elektronik, ANKARA, Turkey
ATM	 Atmel, Torre C2, Polígono Puerta norte, A-23, 50820, (Zaragoza) Spain
ATS	 Atlas Sayaç Sanayi A. ., Erciyes Teknopark 4.Bina Talas, Kayseri, Turkey
AUX	 Ningbo Sanxing Electric Co., Ltd., No.1166, Mingguang North Rd. Jiangshan Town, Ningbo, China
AXI	 UAB "Axis Industries", LT-47190, Lithuania
AZE	 AZEL Electronics, B. Ankara, Turkey
BAM	 Bachmann GmbH & Co KG, Ernsthaldenstr, 33 70565, Stuttgart, Germany
BAR	 Baer Industrie-Elektronik GmbH, Fuerth, Germany
BAS	 BASIC INTELLIGENCE TECHNOLOGY CO.,LTD., 1st Floor, No.1 NanLi Rd. PanYu District, GuangZhou, GuangDong, China.
BBS	 BBS Electronics, Singapore
BCE	 ShenZhen B.C Electronic CO.Ltd, 4F, Strength Building,GaoXin Ave.1.s, South, Hi-technology industry Zone, ShenZhen, China
BEE	 Bentec Electricals & Electronics Pvt Ltd, 150,Upen Banerjee Road,Kolkata, Kolkata, India
BEF	 BEFEGA GmbH, Reichenbacher Str. 22, Schwabach, Germany
BEG	 begcomm Communication AB, Brunnehagen 109, GöteborgSweden
BER	 Bernina Electronic AG
BHG	 Brunata A/S, DK-2730 Herlev, Denmark
BKB	 Boendekomfort AB, Box 37, 260 40 Viken, SWEDEN
BKT	 Bekto Precisa, Ibrahima Popovi a bb., Gora de, Bosnia and Herzegovina
BKO	 Beko Elektronik AS., Istanbul, Turkey
BLU	 Bluering, Brescia, Italy
BME	 Beifeng GmbH, 60599 Frankfurt am Main, Germany
BMI	 Badger Meter Inc., 6116 E 15th St., Tulsa, USA
BMP	 BMETERS Polska Sp.z.o.o., Glowna 60, Psary, Poland
BMT	 BMETERS srl, Via Friuli, 3, 33050, Gonars (UD), ITALY
BRA	 Brandes GmbH, D-23701 Eutin, Germany
BSC	 Sanayeh Sanjesh Energy Behineh Sazan Toos, Toos Industrial Estate,Mashhad,Iran
BSE	 Basari Elektronik A.S. Turkey
BSM	 Bluestar Electrical Meter Research Institute, Nanjing, China
BSP	 Byucksan Power Co. Ltd., 6th Fl. New Hosung Bldg. Yoido-Dong, Youngdeungpo-Gu, Seoul, Korea.
BST	 BESTAS Elektronik Optik, Turkey
BSX	 BS-Messtechnik UG, Kassel, Germany
BTL	 BIT-LAB
BTR	 RIA-BTR Produktions-GmbH, D-78176 Blumberg
BTS	 Basari Teknolojik Sistemler AS, Ankara, Turkey
BUR	 Bopp und Reuther Messtechnik GmbH, Speyer, Germany
BYD	 BYD Company Limited, BYD Road NO.3009 PingShan, ShenZhen, China
BYL	 BAYLAN, Turkey
BXC	 Beijing Fuxing Xiao-Cheng Electronic Technology Stock Co., Ltd, Room 503, Block D, IFEC Blog, No.87 Xisanhuan Beilu, Haidian District, Beijing, China
BZR	 Gebr. Bauer GbR, 87719 Mindelheim, Germany
CAH	 MAEC GROUPE CAHORS, ZI DE REGOURD BP 149, 46003 CAHORS CEDEX 9, FRANCE
CAT	 Cubes And Tubes OY, Olli Kytölän tie 1, MUURAME, FINLAND
CBI	 Circuit Breaker Industries, South Africa
CDL	 Customised Data Ltd., 44 Allerburn Lea, Alnwick, UK
CEB	 Cebyc AS, Vestre Rosten 81 / 13th Floor, Tiller, Norway
CET	 Cetinkaya Aydinlatma, Istanbul, Turkey
CGC	 Contor Group S.A., Romania - 310059 Arad, Calea Bodrogului nr. 2-4
CIR	 Circutor, Viladecavalls/Barcelona, Spain
CLE	 Shen Zhen Clou Electronics Co Ltd, Guangdong, China
CLO	 Clorius Raab Karcher Energi Service A/S
CLY	 Clayster, FO Petersons gata 6, 421 31 Västra Frölunda, Sweden
CMC	 CMC EKOCON d.o.o., IOC ZAPOLJE I/10, LOGATEC, SLOVENIA
CMP	 CM Partner Inc, Yongin, South Korea
CMV	 Comverge, Inc., 5390 Triangle Parkway, Suite 300, Norcross, GA 30041, USA
CNM	 COSTEL, #462-870 COSTEL Bldg., 223-39, Sangdaewon-Dong, Jungwon-Gu, Sungnam-Si, Kyunggi-Do, Korea
COM	 COMMON S.A., Aleksandrowska 67/93, LODZ, POLAND
CON	 Conlog
CPL	 CPL CONCORDIA Soc.Coop., Via A. Grandi, 39 - 41033 Concordia s/S (MO), Italy
CPO	 C3PO S.A., Alejandro Goicoechea 6, Sant Just Desvern, Spain
CRW	 Xuzhou Runwu Science and Technology Development Co. Ltd., NO.5,Huijin Road, Damiao Industry Park,Economic Development Zone, Xuzhou,Jiangsu, P.R.China
CTR	 Contar Electronica Industrial, Lisboa, Portugal
CTX	 Contronix GmbH, Nizzastr 6, Radebeul, Germany
CUC	 cuculus GmbH, Ehrenbergstrasse 11, D-98693 Ilmenau,Germany
CUR	 CURRENT Group, LLC, 20420 Century Boulevard, Germantown, MD, USA
CWI	 Cewe Instrument AB, Nykoping, Sweden
CWV	 CMEC Electric Import & Export Co. Ltd, Beijing 100055, China
CYE	 Quanzhou Chiyoung Electronics Technology Co. Ltd., #20 Hongshan Rd,Shudou community, Changtai St, Quanzhou City, Fujian 362000, China
CYI	 QUANZHOU CHIYOUNG INSTRUMENT CO., LTD, #20 Hongshan Rd,Shudou community, Changtai St, Quanzhou City, Fujian, China 362000
CYN	 Cynox, Weinart Engineering, Bad Zwischenahn, Germany
CZA	 Contazara, Zaragoza, Spain
CZM	 Cazzaniga S.p.A.
DAE	 DAE Srl, Via Trieste, 4/E, Santa Lucia di Piave, Italy
DAF	 Daf Enerji Sanayi ve Ticaret A.S, Atasehir Bulvari Ata Carsi Kat:4 No:52 34758 Atasehir, Istanbul, Turkey
DAN	 Danubia
DBE	 Decibels Electronics P Ltd, Decibels Electronics Pvt Ltd., 6-1-85/4, Saifabad, Hyderabad, AP, India
DDE	 D&D Elettronica srl, Via XXV Aprile, 37, Bresso (MI), ITALY
DEC	 DECODE d.o.o. Data Communications, Belgrade
DEL	 DELTAMESS DWWF GmbH, Sebenter Weg 42, 23758 Oldenburg in Holstein, Germany
DES	 Desi (Alarms) Ltd, Turkey
DEV	 Develco Products, Olof Palmes Allé 40, 8200 Aarhus N, Denmark
DFE	 Dongfang Electronics Co., Ltd., JiChang road 2#, Yantai City, Shandong Province, China
DFS	 Danfoss A/S
DGC	 Digicom S.p.A., Via A.Volta 39, 21010 Cardano al Campo (VA), Italy
DGM	 Diehl Gas Metering GmbH, Industriestrasse 13, Ansbach, Germany
DIE	 Dielen GmbH, Zeppelinstrasse 9, 47638 Straelen, Deutschland
DJA	 De Jaeger Automation bvba, Molenstraat 200, B-9900 EEKLO, Belgium
DKY	 Electric Power Research Institute of Guangdong Power Grid Corporation, No. 8, Shui jungang Dongfengdong Road, Guangzhou, China
DIL	 DECCAN INFRATECH LIMETED, A3-4/A,Electronic Complex, Kushaiguda, HYDERABAD, INDIA
DMC	 DMC International, Al Gharhoud, Dubai, UAE
DME	 DIEHL Metering, Industriestrasse 13, 91522 Ansbach, Germany
DMP	 DM Power Co., Ltd, #SB118 Megavalley, Gwanyang,-Dong, Anyang City, South Korea
DNO	 DENO d.o.o, Zagreb, Croatia
DNT	 Dr Neuhaus Telekommunikation GmbH, Hamburg, Germany
DNV	 DNV KEMA, Utrechtseweg 310, Arnhem, Netherlands
DPP	 DECCAN POWER PRODUCTS PVT. LTD., A3-4/A, Electronic Complex, Kushaiguda, Hyderabad-500062, INDIA
DRT	 DRESSER Italia S.r.l., Via Roma, 772, Talamona (SO), Italy
DSE	 Digitech Systems and Engineering Private Limited, 18 Ramamurthy Street, Nehru Nagar, Chromepet, Chennai-600044, Tamil Nadu, India
DSE	 DSE energy Co., Ltd, 8F, No.531, HsinTien, Taipei, Taiwan
DWZ	 Lorenz GmbH & Co. KG, Burgweg 3, 89601 Schelklingen, Germany
DZG	 Deutsche Zahlergesellschaft
EAA	 Electronic Afzar Azma, Iran
EAH	 Endress+Hauser, 87484 Nesselwang, Germany
EAS	 EAS Elektronik San. Tic. A.S., Ankara, Turkey
ECH	 Echelon Corporation, 550 Meridian Avenue, San Jose, California, USA.
ECL	 Electronics Corporation of India Ltd, Hyderabad, India
ECS	 Herholdt Controls srl, Milan, Italy
EDI	 Enel Distribuzione S.p.A, Via Ombrone, 2, Rome, Italy
EDM	 EDMI Pty. Ltd.
EEE	 3E s.r.l., Via Biandrate, 24, Novara, Italy
EEO	 Eppeltone Engineers, A 293/1 Okhla Industrial Area Phase 1, New Delhi, India
EFA	 EFACEC Engenharia e Sistemas SA, Apartado 3078, MAIA, PORTUGAL
EFE	 Engelmann Sensor GmbH, Rudolf-Diesel-Straße 24-28, 69168 Wiesloch, Germany
EFR	 Europäische Funk-Rundsteuerung, Nymphenburger Strasse 20b, Munich, Germany
EGA	 eGain International AB, Faktorvägen 9, Kungsbacka, Sweden
EGM	 Elgama-Elektronika Ltd, Lithuania
EHL	 Secure Meters Limited
EIT	 EnergyICT NV, 8500 Kortrijk, Belgium
EKA	 Eka Systems, Germantown, MD 20874, USA
EKT	 PA KVANT J.S., Russian Federation
ELD	 Elektromed Elektronik Ltd, Turkey, O.S.B. Uygurlar Cad. No:4 Sincan, Ankara, Turkey
ELE	 Elster Electricity LLC, 208 Rogers Lane, Raleigh, USA
ELG	 Elgas s.r.o., Pardubice, Czech Republic
ELM	 Elektromed Elektronik Ltd, Turkey
ELO	 ELO Sistemas Eletronicos S.A., Brazil
ELQ	 ELEQ b.v., Karl-Ferdinand-Braun-Straße 1, Kerpen, Germay
ELR	 Elster Metering Limited, 130 Camford Way, Luton, UK
ELS	 Elster GmbH, 55252 Mainz-Kastell, Germany
ELT	 ELTAKO GmbH, Hofener Straße 54, 70736 Fellbach, Germany
ELV	 Elvaco AB, Kungsbacka, Sweden
EMC	 Embedded Communication Systems GmbH, vom Staal-Weg 10, 4500 Solothurn, Switzerland
EME	 SC. Electromagnetica SA, Bucharest, Romania
EMH	 EMH metering GmbH & Co. KG (formerly EMH Elektrizitatszahler GmbH & CO KG)
EML	 Emlite ltd, 10 Reynolds Business Park, Stevern Way, PE1 5EL Peterborough, UK
EMM	 Email Metering, Australia
EMO	 Enermet
EMS	 EMS-PATVAG AG, CH-7013 Domat/Ems, Switzerland
EMT	 Elster Messtechnik GmbH, Lampertheim, Germany
EMU	 EMU Elektronik AG, 6432 Rickenbach SZ, Switzerland
END	 ENDYS GmbH
ENE	 ENERDIS, 16 rue Georges Besse SILIC44, 92182 ANTONYFRANCE
ENG	 ENER-G Switch2 Ltd, The Waterfront, Salts Mill Rd, Bradford, BD17 7EZ, UK
ENI	 entec innovations GmbH, Hebelstr. 1, 79379 Müllheim, Germany
ENL	 ENEL d.o.o. Beograd, Belgrade, Serbia and Montenegro
ENM	 ENMAS GmbH, Holzkoppelweg 23, Kiel, Germany
ENO	 ennovatis GmbH, Stammheimer 10Kornwestheim, Germany
ENP	 "Kiev Polytechnical Scientific Research"
ENR	 Energisme
ENS	 ENSO NETZ GmbH, Postfach 12 01 23, 01002 Dresden, Dresden, Deutschland
ENT	 ENTES Elektronik, Istambul
ERE	 Enermatics Energy (PTY) LTD, Mertech Building, Glenfield Office Park, Oberon str., Faerleglen, Pretoria, South Africa
ERI	 Easun Reyrolle Limited, 389, Rasukumaki, Hulimavu, Bannerghatta Road, Bangalore-560076, India
ERL	 Erelsan Elektrik ve Elektronik, Turkey
ESE	 ESE Nordic AB, Slottagårdsgatan 9, Vellinge, Sweden
ESI	 Monosan Monofaze Elektrik Motorlari, Turkey
ESM	 Monosan Monofase Elekrik Motorlari, Turkey
ESO	 Monosan Monofaze Elektrik Motorlari, Turkey
ESS	 Energy Saving Systems LTD., Zroshyvalna, 15b, Kiev, Ukraine
ESY	 EasyMeter GmbH
EUE	 E+E Electronic, Langwiesen 7, 4209 Engerwitzdorf, Austria
EUR	 Eurometers Ltd
EVK	 EV KUR ELEKTRIK, Istanbul, Turkey
EWG	 EWG DOO, Bulevar Svetog Cara Konstantina 80-82, Ni , 18106, Serbia
EWT	 Elin Wasserwerkstechnik
EYT	 Enerlyt Potsdam GmbH
FAN	 Fantini Cosmi S.p.A., Via dell"Osio 6, 20090 Caleppio di Settala, Miano, Italy
FAR	 FARAB, No. 18, Mirhadi St., Jooybar St., Fatemi Sq., Tehran, IRAN
FED	 Federal Elektrik, Turkey
FFD	 Fast Forward AG, Ruedesheimer Strasse 11, Munich, Germany
FIM	 Frodexim Ltd, Sofia, Bulgaria
FIN	 Finder GmbH, Hans-Böckler-Starße 44, 65468 Trebur-Astheim, Deutschland
FLE	 XI'AN FLAG ELECTRONIC CO.,LTD, Flag Electronic Industry Park,No.11,Zhangba 6 Rd.(New Zone), Hi-Tech Development Zone, Xi'an, ShaanXi, PRC., China
FIO	 Pietro Fiorentini, Via Rosellini,1, Milano, Italy
FLG	 FLOMAG s.r.o, Brno, Czech Republic
FLO	 Flonidan A/S, 8700 Horsens, Denmark
FLS	 FLASH o.s, Istanbul, Turkey
FMG	 Flow Meter Group, Menisstraat 5c, 7091 ZZ Dinxperlo, The Netherlands
FML	 Siemens Measurements Ltd. (Formerly FML Ltd.)
FNX	 Flownetix Ltd, Marlow Bottom, Bucks, UK
FRE	 Frer Srl, Viale Europa, 12, Cologno Monzese (MI), Italy
FSP	 Finmek Space S.p.A., I-34012 Trieste
FTL	 Tritschler GmbH, Schönaustr. 10+12, Laufenburg, Deutschland
FUS	 Fuccesso, 98 Yingchundong, Taizhou, China
FUT	 first:utility, Tachbrook Park, Warwick, UK
FWS	 FW Systeme GmBH, Ehnkenweg 11, 26125 Oldenburg, Germany
GAV	 Carlo Gavazzi Controls S.p.A, Via Safforze 8 C.A.P. 32100, Belluno, Italy
GBJ	 Grundfoss A/S
GCE	 Genergica, Caracas, Venezuela
GEC	 GEC Meters Ltd.
GEE	 GE Energy, Lauder House, Almondvale Business Park, Livingston, UK
GEL	 Industrial Technology Research Institute, Rm. 809, Blg.51, No. 195, Sec. 4, Chung Hsing Rd., Chutung, Hsinchu, Taiwan
GEN	 Goerlitz AG, Germany
GEO	 Green Energy Options Limited, 3 St. Mary"s Court, Main Street Hardwick, Camridge, England, CB23 7QS
GET	 Genus Electrotech Ltd., Survey No-43,Galpadar Road, Taluka anjar, District-kutch, gandhidham-370110 Gujrat, Taluka anjar,India
GFM	 GE Fuji Meter Co.,Ltd., Horigane Karasugawa 2191, Azumino-City Nagano, Japan
GIL	 Genus Innovations Limited, SPL-2B, RIICO Industrial Area, Sitapura, Jaipur, India
GIN	 Gineers Ltd, 1756 Sofia, Bulgaria
GMC	 GMC-I Messtechnik GmbH, Südwestpark 15, D-90449 Germany
GME	 Global Metering Electronics, Amsterdam, Netherlands
GMM	 Gamma International Egypt, Abour, St 130, industrial area, Cairo, Egypt
GMT	 GMT GmbH, Odenwaldstraße 19, 64521 Groß-Gerau, Germany
GOE	 Genus Overseas Electronics Ltd, Jaipur, India
GRE	 GE2, Green Energy Electronics, R. Fonte Caspolina, N.6,2.C, 2774-521, PACO DE ARCOS, Portugal.
GRI	 Grinpal Energy Management, 50 Oak Avenue, Pretoria, South Africa
GSP	 Ingenieurbuero Gasperowicz
GST	 Shenzhen Golden Square Technology Co.,Ltd, Zone C&D,5/F,Block A3,Shenzhen Digital Technology Park,Hi-Tech South 7 Rd.,Nanshan ,Shenzhen,Guangdong, China
GTE	 GREATech GmbH, Lindenstrasse 66a, 45478 Muelheim an der Ruhr, Germany
GTS	 GIGATRONIK Stuttgart GmbH, Hortensienweg 21, 70374, Stuttgart, Germany
GUH	 ShenZhen GuangNing Industrial CO.,Ltd, Room 802, 8th Floor, ShenZhen Software Building ,NanShan, District,ShenZhen ,China
GWF	 Gas- u. Wassermesserfabrik Luzern
HAG	 Hager Electro GmbH, 66131 Saarbruecken, Germany
HCE	 Hsiang Cheng Electric Corp, Hsin-Tien City, Taipei, R.o.China
HEG	 Hamburger Elektronik Gesellschaft
HEI	 Hydro-Eco-Invest SP. Z O.O., Gliwice, Poland
HEL	 Heliowatt
HER	 Hermes Systems, Australia
HFR	 SAERI HEAT METERING TECHNOLOGY CO.,LTD, WANLIAN ROAD 1,SHENHE DISTRICT SHENYANG CHINA
HIE	 Shenzhen Holley South Electronics Technology Co., Ltd., 7/F, No.2 Jianxing Building, Chaguang Industrial Zone, Nanshan District, Shenzhen, China
HLY	 Holley Metering Ltd
HMI	 HMI Energy Co., Ltd, No.38, Alley 175, Lane 75, Sec3, Kongning Rd., Neihu, Taipe, Taiwan
HMS	 Hermes Systems, Australia
HMU	 Hugo Müller GmbH & Co KG, Sturmbühlstraße 145-149, 78054 VS-Schwenningen, Germany
HND	 Shenzhen Haoningda Meters Co., Ltd., 6/F, Huake Mansion, East Science Park, Qiaoxiang Rd, Nanshan District, Shenzhen, China
HOE	 HOENTZSCH GMBH, Gottlieb-Daimler-Str.37, 71334 Waiblingen, Germany
HOL	 Holosys d.o.o, Matije Gupca 7, 49243, Oroslavje, Croatia
HON	 Honeywell Technologies Sarl, Ecublens, Switzerland
HPL	 HPL-Socomec Pvt. Ltd., 133 Pace City 1, Sector 37, Gurgaon, India
HRM	 Hefei Runa Metering Co., Ltd, 1102# jinchi Rd. Luyang industrial park, Hefei, Anhui Province, Hefei, CHINA
HRS	 HomeRider SA, France
HSD	 Ningbo Histar Meter Technology Co.,Ltd., No.181 Haichuan Road Jiangbei District, Ningbo City, Zhejiang Province, CHINA
HST	 HST Equipamentos Electronicos Ltda
HTC	 Horstmann Timers and Controls Ltd.
HTL	 Ernst Heitland GmbH & Co. KG, Erlenstr. 8-10, 42697 Solingen, Deutschland
HTS	 HTS-Elektronik GmbH
HWT	 Huawei Technologies Co. Ltd., Department of Industry Standards, Huawei Industrial Base, Shenzhen, China
HXD	 Beijing HongHaoXingDa Meters CO.,LTD, HouXing,the third street,18,HuoXian, TongZhou., Beijing, China(P.R.C)
HXE	 Hexing Electrical Co., Ltd, Hangzhou, China
HXW	 Hangzhou Xili Watthour Meter Manufacture Co. Ltd., No. 14, JiaQi Road, XianLin Industrial Park, Yuhang District, Hangzhou, China
HYD	 Hydrometer GmbH
HYE	 Zhejiang Hyayi Electronic Industry Co Ltd, Zhejiang, China
HYG	 Hydrometer Group, 91522 Ansbach, Germany
HZC	 TANGSHAN HUIZHONG INSTRUMENTATION CO., LTD., Qinghua Road,New and Hi-Tech Development, Zone,Tangshan,Hebei Province,China, Tangshan, China
HZI	 TANGSHAN HUIZHONG INSTRUMENTATION CO., LTD., Qinghua Road,New and Hi-Tech Development, Zone,Tangshan,Hebei Province,China, Tangshan, China
ICM	 Intracom, Greece
ICP	 PT Indonesia Comnets Plus, PLN building 9th Floor Jl.Jendral Gatot Subroto kav.18, Jakarta Selatan, Indonesia
ICS	 ICSA (India) Limited, Plot No. 12, 1st Floor, Software units Layout, Cyberabad, Hyderabad, India
ICT	 International Control Metering-Technologies GmbHWillhoop 7, D-22453 Hamburg, Germany
IDE	 IMIT S.p.A
IEC	 leonnardo Corporation, Peremogy, 31, Sutysky, Ukraine
IEE	 I.E. Electromatic, S.L, Quart de Poblet (Valencia), Spain
IFX	 Infineon Technologies, AM Campeon 1-12, Nuebiberg, Germany
IHM	 Shenzhen Inhemeter Co., Ltd., 7/F, Science & Industry Park Building, Science & Industry Park, Nanshan District, Shenzhen, China
IJE	 ILJIN Electric, Kyunggi-Do, Korea
IKS	 IKASIAN, Av. Josep Tarradellas, 38. SBC Office 55, Barcelona, Spain
IMS	 IMST GmbH, Carl-Friedrich-Gauss-Straße 2-4, 47475 Kamp-Lintfort, Germany
INC	 Incotex, 16th Parkovaya st, 26, Moscow, Russia
IND	 INDRA SISTEMAS, Avda. Bruselas, 35, Alcobendas (Madrid)
INE	 INNOTAS Elektronik GmbH, Rathenaustr. 18a, 02763 Zittau, Germany
INF	 Infometric, Sollentunavägen 50, 19140 Sollentuna, Sweden
INI	 Altero AB, 21211 Malmoe, Sweden
INP	 INNOTAS Produktions GmbH, Rathenaustr. 18a, 02763 Zittau, Germany
INS	 INSYS MICROELECTRONICS GmbH, Hermann-Köhl-Str. 22, 93049, Regensburg, GERMANY
INT	 Infranet Technologies GmbH, 21079 Hamburg, Germany
INV	 Sensus Metering Systems, Ludwigshafen/Rh, Germany
INX	 Innolex Engineering BV, Molenlei 2A, Akersloot, The Netherlands
IPD	 IPD Industrial Products Australia, Sydney, Australia
ISI	 Akcionarsko Drustvo "Insa Industrija Satova, Trscanska 21, Belgrade-Zemun, Serbia
ISK	 Iskraemeco, Slovenia
ISO	 Isoil Industria spa, via F.lli Gracchi n.27, Cinisello Balsamo (Milan), Italy
IST	 Ista
ITA	 iTrona GmbH, CH-6432 Rickenbach SZ, Switzerland
ITB	 ITRON Brazil, rua Fioravante Mancino, 1560, CEP: 13175-575 Sumaré, Brazil
ITC	 INTECH TUNISIE, Rue de Tozeur ZI Hammam Zriba, Zaghouan, Tunisia
ITE	 ITRON (Electricity), 52, Avenu Camille Desmoulin, 92130 Issy les Moulineaux, FRANCE
ITG	 ITRON (Gas), 52, Avenue Camille Desmoulin, 92130 Issy les Moulineaux, FRANCE
ITH	 INTELTEH d.o.o., Bozidara Magovca 87, 10000, Zagreb, Croatia
ITF	 ITF Fröschl GmbH, Hauserbachstrasse 9, 93194 Walderbach, Germany
ITI	 ITRON Asia, EJIP Plot 6B-2, Lemah Abang, Bekasi 17550, Jawa Barat, Indonesia
ITR	 Itron
ITS	 ITRON Australia, Rosberg Road, Wingfield, SA, 5013, Adelaide, Australia
ITU	 ITRON United States, 2111 N Molter Road, Liberty Lake, WA 99019, United States
ITW	 ITRON (Water), 52, Avenue Camille Desmoulin, 92130 Issy les Moulineaux, FRANCE
ITZ	 ITRON South Africa, Tygerberg Office Park, Hendrik, Verwoerd Drive, 7500 Plattekloof, Cape Town, South Africa
IUS	 IUSA SA DE CV, Km 109 Carr Panamericana, Pasteje Jocotitlan Edo. de Mex., Mexico
IWK	 IWK Regler und Kompensatoren GmbH
IZE	 iZenze AB, Slottagårdsgatan 9, 235 35 Vellinge, Sweden
JAN	 Janitza electronics GmbH, Lahnau-Waldgirmes, Germany
JCE	 Janz Contadores de Energia SA, Lisbon, Portugal
JED	 JED Co Ltd, Dongan-Gu, Anyang, Kyunggi-Do, South Korea
JGF	 Janz Contagem e Gestao de Fluidos SA, Lisbon, Portugal
JHM	 Changzhou Jianhu Intelligentize Meter Co.,Ltd., No.11 Lijia Industrial District,Wujin, Changzhou, China
JMT	 JM-TRONIC Sp. z o.o., ul. Wybrze e Ko ciuszkowskie 31/33, 00-379 Warszawa, Poland
JOY	 Zhejiang Joy Electronic Technology Co., Ltd., No. 333 North Chayuan Road, Youchegang Town, Xiuzhou District, Jiaxing, China
JUM	 JUMO GmbH & Co. KG, Herrmann - Muth - Strasse 1, 36039 Fulda, Germany
KAM	 Kamstrup Energi A/S
KAS	 Kamstrup A/S, Industrivej 28, 8660 Skanderborg, Denmark
KAT	 KATHREIN-Werke KG, Anton-Kathrein-Straße 1-3, D-83022 Rosenheim, Germany
KBN	 Alpamis IT Ltd, ANKARA, Turkey
KEL	 KELEMINIC d.o.o., Zagreb, Croatia
KER	 KERMS UG (haftungsbeschränkt), Fontanestraße 39, 15569 Woltersdorf, Germany
KFM	 Shenzhen KAIFA Technology Co, Ltd, Shenzhen, China
KGE	 Guangzhou Keli General Electric Co., Ltd, No1.Sui Hua Nan street, Jiang Nan Da Dao Zhong Road, Guangzhou P.R.China
KHL	 Kohler, Turkey
KKE	 KK-Electronic A/S
KMB	 Kamstrup A/S, Industrivej 28, Stilling, DK 8660 Skanderborg, Denmark
KMT	 Krohne Messtechnik GmbH, Ludwig-Krohne-Straße, Duisburg,Germany
KNX	 KONNEX-based users (Siemens Regensburg)
KRO	 Kromschroder
KST	 Kundo SystemTechnik GmbH
KSY	 KUNDO SystemTechnik GmbH, St Georgen, Germany
KTC	 Kerman Tablo Co, Tehran, Iran
LAC	 Heinz Lackmann GmbH & Co KG, Harkortstrasse 15, 48163 Münster, Germany
LAN	 Langmatz GmbH, Am Gschwend 10, Garmisch-Partenkirchen, Germany
LCG	 Landis+Gyr Meter & System (Zhuhai) Co., Ltd, No.12 Pingdong 3RD,Nanping Industry Community,Zhuhai 519060, P.R.China
LCR	 ShanDong LiChuang Science and Technology Co.,Ltd, No. 9 Fenghuang Road High-tech District, Laiwu ShandongChina
LDE	 Shenzhen Londian Electrics Co., Ltd, 3/F, Build 107#, 1st Nanyou Industrial Zone, Nanshan District, Shenzhen, China
LEC	 Lectrotek Systems Pvt Ltd, 33 Parvati Industrial Estate, 411009, Pune, India
LEM	 LEM HEME Ltd., UK
LFS	 Payolcer Metering Devices, Erciyes Un versity Cybertech Center-4 Num:25, KAYSERI, TURKEY
LGB	 Landis+Gyr Ltd., UK
LGD	 Landis+Gyr GmbH, Germany
LGS	 Landis+Gyr (Pty) Ltd. South Africa
LGU	 LG Uplus Corp, Namdaemunno 5-ga, Jung-gu, Seoul, Korea
LGZ	 Landis+Gyr AG Zug
LHA	 Atlantic Meters, South Africa
LML	 LUMEL, Poland
LNT	 Larsen & Toubro Ltd, MPS, KHebbal-Hootagalli, Mysore, India
LSE	 Landis & Staefa electronic
LSK	 LS Industrial Systems Co Ltd, Cheongju, South Korea
LSP	 Landis+Gyr GmbH, Germany
LSZ	 Siemens Building Technologies
LUG	 Landis+Gyr GmbH, Germany
LUN	 Protokol Sanayi ve Ticaret, Karacaoglan Mah., 167 Sok., No 42 Isikkent, Izmir, Turkey
LYE	 Jiangsu Linyang Electronics Co.,Ltd., No.666,Linyang Road, Qidong, China
MAC	 RUDNAP Group Meter & Control, Omladinskih brigada 182, Belgrade, Serbia
MAD	 Maddalena S.p.A.. Italy
MAE	 Mates Elektronik Metin Ates, Ankara, Turkey
MAN	 Manthey GmbH, Walter-Freitag-Str. 30, 42897 Remscheid, Deutschland
MAT	 Mitsubishi Electric Automation, Bangkok, Thailand
MAX	 MAXMET Inc, Seogu, Daejeon 302-834, Korea
MBS	 MBS AG, Eisnachstraße 51, 74429 Sulzbach-Laufen, Germany
MCR	 MICRORISC, D lnická 222, Ji ín, Czech Republic
MDE	 Diehl Metering Deutschland, Industriestraße 13, Ansbach, Germany
MEC	 Mitsubishi Electric Corporation, 1-8, Midorimachi Fukuyama-city Hiroshima, 720-8647, Japan
MED	 MAHARASHTRA STATE ELECTRICITY DISTRIBUTION COMPANY LIMITED, PLOT NO. G-9, PRAKASHGAD, 5TH FLOOR, PROF. ANANT KANEKAR MARG, BANDRA (EAST)MUMBAI 400051, INDIA
MEH	 Mueller-electronic GmbH, Fritz-Garbe-Str. 2, 30974, Wennigsen, Germany
MEI	 Sensus Metering Systems, Ludwigshafen/Rh, Germany
MEL	 Mikroelektronika a.d, Banja Luka, Bosnia and Herzegovina
MEM	 MEMS AG, Segelhofstrasse, CH-5405 Baden-Dättwil, Switzerland
MET	 METRA Energie-Messtechnik GmbH, Speyer, Germany
MIC	 Microtronics Engineering GmbH, Hauptstrasse 7, A-3244 Ruprechtshofen, Austria
MII	 Miitors ApS, Miitors ApS, VBI Park, Chr. M Østergaardsvej 4aDK-8700 Horsens, Denmark
MIM	 Malaysian Intelligence Meters Sdn. Bhd., No. 3, Jalan Pemberita U1/49, Temasya Industrial Park, Seksyen U1, Glenmarie Shah Alam, Selangor Darul Ehsan, Malaysia
MIR	 MIR Research and Production Association, 51 Uspeshnaya644105 Omsk, Russia
MIS	 Iskra MIS d.d, 4000 Kranj, Slovenia
MKE	 MKEK Genel Mudurlugu Gazi Fisek (ELSA), Ankara, Turkey
MKL	 MAKEL Elektrik Malzemeleri, Turkey
MKS	 MAK-SAY Elektrik Elektronik, Turkey
MMC	 Modern Meters Co., Damascus Sahnaya, Syria,
MMI	 MyMeterInfo, 95 rue du Morellon, 38070 Saint Quentin, Fallavier, France
MMS	 Brunswick Bowling and Billiards UK Ltd, Unit L1, Temple Court, Knights Park, Knight Road, Strood, Kent, UK
MNS	 MANAS Elektronik, Turkey
MOS	 MOMAS SYSTEMS NIGERIA LIMITED, #4, Bode Thomas Street, Surulere, Lagos, NIGERIA
MOT	 The Motwane Manufacturing Company Private Limited, Gyan Baug, Motwane Road, Nasik Road, Nasik, India
MPA	 Mega Power Automation International Limited, 16/F., Block A-1, Fortune Factory Building, 40 Lee Chung Street, Chai Wan, Hong Kong.
MPR	 Michael Rac GmbH, Sonnenfeld 29, 91522 Ansbach, Germany
MPS	 Multiprocessor Systems Ltd, Bulgaria
MRT	 MIRTEK LTD., Gagarin street, Building 4, Stavropol, Russia
MSB	 MISA SDN BHD, LOT 30, JALAN MODAL 23/2, 40300, SHAH ALAM, SELANGOR, MALAYSIA
MSE	 Mahashakti Energy Limited, A-8, New Focal Point, Dabwali Road, Bathinda (Punjab), India
MSM	 MS-M Co., Ltd., 237 Bukjung-Dong Yangsan-City, Korea
MSO	 Metiso, Tr anska 21, Zemun, Belgrade, Serbia
MSY	 MAK-SAY Elektrik Elektronik Malzemeleri, Turkey
MTD	 Removed - November 2006
MTC	 Metering Technology Corporation, USA
MTH	 njmeter, Binjiang Development Zone of Jiangning Road No. 6Nanjing, China
MTI	 Micrtotech Industries Pakistan, Plot#2,Street#2,Attari industrial estate 18-Km. Ferozepure Raod, Lahore, Pakistan
MTM	 Metrum Sweden AB, Vestagatan 2A, Gothenburg, Sweden
MTS	 MeteRSit S.r.L., Viale dell"Industria, 31, Padova, Italy
MTX	 Matrix Energy Pvt. Ltd., Soni Arcade, No. 242, 2nd Floor, 7th Cross, 6th Block, Banashankari 3rd Stage, Bangalore, INDIA
MUK	 Meters UK Ltd, Whitegate, White Lund Trading Estate, Lancaster, UK
MWU	 METRONA Wärmemesser Union GmbH, Aidenbachstraße 40, 81379 München, Germany
MXM	 Maxim India Integrated Circuit Design Pvt Ltd., 132/133, Divyasree Technolopolis, Off Airport Road, Bangalore, India
NAR	 NARI Group Corporation-NARI Technology Development Co., Ltd, No.8 NARI Rd. Gulou District, Nanjing, China
NDF	 NÚCLEO DURO FELGUERA, Avda. de la Industria, 24, 28760, Tres Cantos, Madrid
NDM	 Northern Design, 228 Bolton Road, Bradford, United Kingdom
NES	 NORA ELK. MALZ. SAN. ve T C. A. ., nönü Cad. Sümer Sok. Zita Merkezi C1 Blok No:9 Kozyata -Kad köy- STANBUL, TURKEY
NIS	 Nisko Industries Israel
NJC	 NAMJUN Co Ltd, Gimhae Gyoungnam, South Korea
NMS	 Nisko Advanced Metering Solutions Israel
NNT	 2N Telekomunikace a.s., Modranska 621, 14301 Praha 4, Czech Republic
NRM	 Norm Elektronik, Turkey
NTC	 Nuri Telecom Co Ltd, Geumcheon-gu, Seoul, Korea
NTM	 Netinium, Postbus 86, Wormerveer, The Netherlands
NVN	 NOVEN ENERGY AND ICT LTD., Hacettepe University KOSGEB Technology Center T1-Blok B:14 Beytepe, Ankara,Turkiye
NWM	 Ningbo Water Meter Co.Ltd., No.99 Lane 268 Beihai Road Jiangbei District, Ningbo City Zhejiang ProvinceCHINA
NXP	 NXP Semiconductors, High Tech Campus 32, 5656AE Eindhoven, The Netherlands
NYG	 Ningbo Yonggang Instrument Co.,Ltd, Weisan Road, West Industrial Zone, Xinpu Town, Cixi City, China
NYN	 Nanjing Yuneng Instrument Co Ltd, Nanjing, China
NZR	 Nordwestdeutsche Zählerrevision Ing. Aug. Knemeyer GmbH & Co. KG, Heideweg 33, 49196, Bad Laer, Germany
OAS	 Omni Agate Systems, Chennai, India
ODI	 OAS Digital Infrastructures Pvt. Ltd., No:4/3, Stringer Road, Periamet, Vepery, Chennai, INDIA
OEE	 ONUR Elektrik ve Elektronik, Turkey
OMS	 OMNISYSTEM Co., Ltd., Goyang-shi, Gyeonggi-do, Korea
ONR	 ONUR Elektroteknik, Turkey
ONS	 ONUR Elektroteknik, Turkey
OPT	 Optec GmbH, Grundstrasse 22, 8344 Bäretswil, Switzerland
ORB	 ORBIS Tecnologia Electrica, SA, Madrid, Spain
ORM	 Ormazabal, B Basauntz, 2, Igorre, Spain
OSA	 Osaki Electric Co., Ltd.(Europe), Gotanda-Square, Tokyo, Japan
OSK	 Osaki Electric Co Ltd. (Japan), Shinagawa-ku, Tokyo, Japan
OZK	 Oz-kar Enerji, Kayseri, Turkey
PAD	 PadMess GmbH, Germany
PAF	 FAP PAFAL S.A., 26 Lukasinskiego street, widnica, Poland
PAK	 Paktim Energy Sp.zo.o., ul. Swiety Marcin 29/8, 61-806 Poznan, Poland
PAN	 Panasonic Corporation, 800 Tsutsui-cho, Yamatokoriyama-shiNara Pref., Japan
PDX	 Paradox Engineering SA, Via Ronchetto, 9, Cadempino, Switzerland
PEL	 Pak Elektron Ltd. (PEL), 14-km Ferozpur Road, Lahore, Pakistan
PGP	 P.G.P. - Smart Sensing s.a., Rue Fond Cattelain 2 / 1.15, Mont-St-Guibert, Belgium
PHL	 HangZhou PAX Electronic Technology Co., Ltd., China
PII	 PiiGAB Processinformation i Goteborg AB, Sweden
PIK	 pikkerton GmbH, Kienhorststrasse 70, 13403 Berlin, Germany
PIL	 Pilot Systems (London) Ltd, Chiswick, London
PIM	 Power Innovation GmbH, Rehland 2, Achim,Germany
PIP	 Hermann Pipersberg jr., Felder Hof 2, D-42899 Remscheid, Deutschland
PLO	 Weihai Ploumeter Co. Ltd., : No. 28 Hengrui Street, Torch Hi-Tech Industries Development Zone, Weihai, Shandong, China
PMG	 Sensus Metering Systems, Ludwigshafen/Rh, Germany
PMS	 PMS-Elektronik GmbH, Humboldtstraße 14, D-74915, Waibstadt, Germany
POD	 PowerOneData, Bangalore 560082, India
POW	 PowerApp, Esromgade 15 opg. 2 - 2 sal., Copenhagen, Denmark
POZ	 ZEUP Pozyton sp. z o.o, ul. Czestochowa, Poland
PPC	 Power Plus Communications AG, Am Exerzierplatz 2, 68167 Mannheim, Germany
PRE	 Predicate Software, 7 Protea Ave, Dooringkloof, 0140, Centurion, Gauteng, South Africa
PPS	 Palace Power Systems, 50 Oak Avenue, Pretoria, South Africa
PRI	 Polymeters Response International Ltd.
PRG	 Paud Raad Industrial Group, No. 18, 2nd St., Shah Nazari Ave.,Madar Sq., Mirdamad Blvd., Tehran, Iran
PRO	 Proton - Elektromed Ltd, Ankara, Turkey
PST	 PSTec Co.,Ltd, Seoul, Korea
PUK	 Paktim Consulting UK Ltd, 2 West Regent Street, Glasgow, G2 1RW, United Kingdom
PWB	 Paul Wegener GmbH, Ballenstedt, Germany
PWR	 Powrtec, Scotts Valley, CA 95066, USA
PYU	 PYUNGIL Co. Ltd, Anyang-si, Gyeonggi-do, Korea
QDS	 Qundis GmbH, Sondershaeuser Landstrasse 27, Mühlhausen, Germany
QTS	 QT systems ab, Alfavägen 3, 92133 Lycksele, Sweden
RAC	 Michael Rac GmbH, Sonnenfeld 29, Ansbach, Germany
RAD	 Radiocrafts AS, Sandakerveien 64, 0484 OSLO, NORWAY
RAM	 Rossweiner Armaturen und Messgeräte GmbH & Co. OHG, Wehrstraße 8, Roßwein, Germany
RAS	 Rubikon Apskaitos Sistemos, Vilnius, Lithuania
RCE	 RC ENERGY METERING PVT,LTD., B-65 GATE NO.1,N.I.A.PHASE-II NEW DELHI -110028, DELHI, INDIA
REC	 Zhejiang Reallin Electron Co.,Ltd, 2F,Building3,No.202 Zhenzhong Rd,Sandun Technology Park,Xihu District, Hangzhou, China
REL	 Relay GmbH, Germany
REM	 Remote Energy Monitoring, Tring, UK
RIC	 Richa Equipments Pvt. Ltd., Z B 5-6/487, Zulfe Bengal, Dilshad Garden Shahdara, Delhi, India
RIL	 Rikken Instrumentation Limited, Plot No. 369, Phase 2, Industrial Area, Panchkula, India
RIM	 CJSC \"Radio and Microelectronics\", 630082, Novosibirsk, the Red Prospectus, 220, the case 17, Novosibirsk, Russia
RIT	 Ritz Instrument Transformers GmbH, Wandsbeker Zollstr. 92 98, 22041 Hamburg, Germany
RIZ	 RIZ Transmitters, Bozidareviceva 13, Zagreb, Croatia
RKE	 Viterra Energy Services (formerly Raab Karcher ES)
RML	 ROLEX METERS RPIVATE LIMITED, Plot No 20&21, Prashanthi Nagar, Kukatpally Industrial Estate, Hyderabad, India
RMR	 Advanced Technology RAMAR, Christchurch, UK
RSA	 Rahrovan Sepehr Andisheh Pte. Co.
RSW	 RSW Technik GmbH, Giessen, Germany
SAA	 Sanjesh Afzar Asia Ltd. Co., 3 rd Flr/No. 8/16 St./Gandi Ave./Tehran, Iran
SAC	 Sacofgas 1927 SpA, Via Ascanio Sforza 85, Milano, Italy
SAG	 SAGEM, Cergy Saint-Christophe, France
SAM	 Siemens AG Österreich, AMIS (Automated Metering and Information System), Ruthnergasse 3, Vienna, Austria
SAP	 Sappel
SAT	 SATEC Ltd, 7 Hamarpe Street, Jerusalem, Israel
SBC	 Saia-Burgess Controls, Bahnhofstrasse 18, 3280 Murten, Switzerland
SCE	 Seo Chang Electric Communication Co Ltd, Daegu, Korea
SCH	 Schinzel GmbH
SCW	 ScatterWeb GmbH, Charlottenstr. 16, Berlin, Germany
SDC	 SdC Sistemas de Contagem, Vila Nova de Famalicao, PT
SDM	 Shandong Delu Measurement Co., Ltd., Tower C, Qiln Software Park, High-Tech Industrial Development, JiNan, China
SEC	 Schneider Electric Canada, Saanichton, Canada
SEE	 El Sewedy Electrometer Egypt, 6th of October, Egypt
SEN	 Sensus Metering Systems, Ludwigshafen/Rh, Germany
SGA	 smartGAS Mikrosensorik GmbH, Kreuzenstraße 98, 74076 Heilbronn, Germany
SGM	 Swiss Gas Metering AG, Reichenauerstrasse, Domat/Ems, Switzerland
SHD	 Beijing SanHuaDeBao Energy Technoligy Co.,Ltd., Floor4 Jinyanlong R&D Building Jiancaicheng West Road Changping District Beijing City China
SHE	 Shenzhen SingHang Elec-tech Co., Ltd., Rm203-206, Terra Science & Technology Park, Futian District, Shenzhen, China
SHM	 Shanghai Metering, China, No.2065 Kongjiang Road, Shanghai, China
SIE	 Siemens AG
SIT	 SITEL doo, Belgrade, Serbia and Montenegro
SLB	 Schlumberger Industries Ltd.
SLP	 Sylop, ul. Jagiellonska 4, PL-32830 Wojnicz, Poland
SLX	 Ymatron AG, Bruelstrasse 7, Dielsdorf, Switzerland
SMC	 Pending
SME	 Siame, Tunisia
SMG	 Samgas s.r.l., SP 33 km 0,600 20080, Vernate (MI), Italy
SML	 Siemens Measurements Ltd.
SMN	 Saiman Corporation LLC, 162d Shevchenko Street, Almaty, Kazakhstan
SMT	 Smarteh d.o.o., Trg tigrovcev 1, Tolmin, Slovenia
SNM	 ShenZhen Northmeter Co.Ltd , floor 5, Dongshan Building, Huafeng first science park,Baoan, Shenzhen, China
SNR	 NTN-SNR, 1 Rue des Usines, 74010 Annecy, France
SNS	 Signals and Systems India Private Limited, MF-7, Cipet Hostel Road, Thiru-Vi-Ka Industrial Estate, Chennai, India
SOC	 SOCOMEC, 1, rue de Westhouse, 67230 Benfeld, France
SOF	 Softflow.de GmbH, Dorfstasse, 15834 Gross Machnow, Germany
SOG	 Sogecam Industrial, S.A., C/ Rosalind Franklin, 22-24, Campanillas (Málaga), Spain
SOL	 Soledia Srl, Via di Selva Candida 85, Rome, Italy
SOM	 Somesca, 80 rue Jean Jaures, 92270 Boois colombes, France
SON	 Sontex SA
SPL	 Sappel
SPX	 Sensus Metering Systems, Ludwigshafen/Rh, Germany
SRE	 Guangzhou Sunrise Electronics Development Co., Ltd., Guangzhou Avenue South, Guangzhou, Guangdong, China
SRF	 Saraf Industries, Saraf Industries, Bathinda Road, Rampura Phul - 151103, Punjab, India
SRN	 Shandong SARON Intelligent Technology Co., Ltd., 3F,South E,International Business Center, Environmental Technology Area, Middle of Zhengfeng Road, Jinan City Shandong Province,China
SRV	 Servic LLC, Kirova 16-9, Dniprodzerzhinsk, Ukraine
SSN	 Silver Spring Networks, 555 Broadway Street, Redwood City, United States
SST	 Qingdao Haina Electric Automation Systems Co., Ltd., No.151,Zhuzhou Road, Laoshan, Qingdao, China
STA	 Shenzhen Star Instrument Co Ltd, Shenzhen, China
STC	 Sunrise Technology Co., Ltd, Building C, Xiyuan 8th Road 2#, West-Lake Technological & Economic Zone, Hangzhou, China
STD	 Stedin, Essebaan 71, Capelle a/d Ijssel, Netherlands
STR	 Strike Technologies, South Africa
STV	 STV Automation, Branch of STV Electronic, Detmold, Germ.
STZ	 Steinbeis Innovation Center Embedded Design and Networking c/oUniversity of Cooperative Education Loerrach Hangstrasse 46-50, D79539 Loerrach
SVM	 AB Svensk Värmemätning SVM
SWI	 Swistec GmbH, Graue-Burg-Strasse 24-26, Bornheim, 53332 Germany
SWT	 Beijing Swirling Technology Co. Ltd, Beijing, China
SYN	 SMSISTEM Ltd., ANKARA, Turkey
TAG	 Telma AG, Gewerbeweg 10, 3662 Seftigen, Switzerland
TAT	 Tatung Co., 22, Chungshan N. Rd., 3rd Sec., Taipei, Taiwan
TAY	 Taytech Otomasyon ve Bilisim Teknolojileri LTD. Sti, Tasdelen Gungoren Mah. Izan Sok. No:15 Cekmekoy., Istanbul, Turkey
TCE	 Qindao Techen Electronic Technology Co.,LTD, No. 169 Songling Road. Laoshan District, Qingdao, China
TCH	 Techem Service AG & Co. KG
TDC	 Telecom Design, Rue Romaine Voie de Remora, GradignanFRANCE
TEC	 TECSON Digital, Felde, Germany
TEP	 TEPEECAL, 69730 Genay, France
TFC	 Toos Fuse Co. 375 Sanat Blvd. Toos Industrial Estate, Mashad, Iran
THE	 Theben AG, Hohenbergstrasse 32, 72401 Haigerloch, Germany
TIP	 TIP GmbH, Bahnhofstr. 26, 99842 Ruhla, Germany
TIX	 Tixi.Com GmbH, D-13465 Berlin
TLM	 Theodor Lange Messgeräte GmbH, Rodeberg 7, 31226 Peine,Germany
TMK	 Timi Kosova Sh.p.k.
TMS	 TEMASS IMALAT A.S, Macunkoy, Ankara, Turkey
TPL	 Teplocom Holding, 45, Vyborgskaya Naberezhnaya, ST Petersburg, Russian Federation
TRI	 Tritech Technology AB, Sturegatan, 10-12 PO Box 1094, SE-172 22 Sundbyberg, Stockholm, Sweden
TRJ	 SHENZHEN TECHRISE ELECTRONICS CO.,LTD, Building 112,1st Industrial park, Liantang, Luohu District, Shenzhen City, China.
TRL	 Trilliant Inc., 610 du Luxembourg, Granby, (Quebec), Canada, J2J 2V2
TRV	 Transvaro Elektron Aletleri A.S., Turkey
TSD	 Theobroma Systems Design und Consulting GmbH, Gutheil-Schoder Gasse 17, Wien, Austria
TTM	 Toshiba Toko Meter Systems Co., Ltd., 12-7, Shiba 1-chome, Minato-ku, TOKYO, JAPAN
TTR	 Tetraedre Sarl, Epancheurs 34b, 2012 Auvernier, Switzerland
TTT	 Telephone and Telegraph Technique Plc, Sofia, Bulgaria
TUR	 TURKSAY ELEKTRONIK ELEKTRIK ENDUSTRISI
TXL	 CETC46 TianJin New Top Electronics Technology Co.,Ltd., KEYAN East Road 15,Nankai District, Tianjin, China
UAG	 Uher
UBI	 Ubitronix system solutions gmbh, 4232 Hagenberg, Austria
UEI	 United Electrical Industries Limited, Pallimukku, Kollam, India
UGI	 United Gas Industries
UTI	 Utilia Spa, Via Chiabrera, 34/D, Rimini (RN 47924), Italia
UTL	 United Telecoms Limited, A-1/A, 2nd Floor, Revati Building, ECIL XRoads. Hyderabad, INDIA
VER	 VERAUT GmbH, Siemensstr.52, Linz, Austria
VES	 Viterra Energy Services
VIK	 VI-KO ELEKTRIK, Istanbul, Turkey
VMP	 VAMP Oy., Yrittäjänkatu 15 P.O. Box 810 Fl-65101, Vaasa, Finland
VPI	 Van Putten Instruments B.V.
VSE	 Valenciana Smart Energy of Mediterranean Sea S.A, Sir Alexander Fleming, 12 . Warehouse 11, Parque tecnologico de Valencia, 46980, Valencia, Spain
VTC	 Vitelec, Kapittelweg 18, NL 4827 HG Breda, Postbus 6543, NL 4802 HM Breda, Netherlands
VTK	 Linkwell Telesystems Pvt. Ltd., Gowra Kalssic, 1-11-252/1/A, Begumpet, Hyderabad 500016, India
YTL	 ZheJiang yongtailong electronic co.,ltd, No.8 KangDing Road, Tongxiang, China
WAH	 WAHESOFT UG, Moeoerte 16, 26316 Varel, Germany
WAI	 Chongqing WECAN Precision Instruments Co.,Ltd, #66 HuangShan Rd,HI-Tech Park , New North Zone, ChongqingP.R.China
WAL	 Wallaby Metering Systems Pvt. Ltd., M-3, 9th Street, Dr.VSI Estate, Thiruvanmiyur, Chennai - 600 041, INDIA
WDN	 Webdyn SA, 26 rue des Gaudines, 78100 Saint Germain en Laye, France
WEB	 Webolution GmbH & Co. KG, Sendenhorsterstrasse 32, 48317 Drensteinfurt, Germany
WEG	 WEG Equipamentos Elétricos S.A. Automação, Av. Pref. Waldemar Grubba, 3000, Jaraguá do Sul, Brazil
WEH	 E. Wehrle GmbH, Obertalstraße 8, 78120 Furtwangen, Germany
WEL	 WELLTECH automation, 263# HongZhong Road, Shanghai,P.R.China
WFT	 Waft Embedded Circuit Solutions, A-109, Sahni Tower, Sector-5, Rajendra Nagar, Sahibabad, Ghaziabad (U.P.), India
WIN	 Windmill Innovations BV, Paasbosweg 14-16, 3862 ZS, Nijkerk (GLD), The Netherlands
WMO	 Westermo Teleindustri AB, Sweden
WSD	 Yantai Wisdom Electric Co., Ltd., JiChang road 2#, Yantai, Shangdong Province, China
WSE	 Changsha Weisheng Electronics Ltd, Changsha, P.R. China
WTI	 Weihai Sunts Electric Meter Co., Ltd, 39-7#, Shenyang Middle Rd. Gaoji Weihai CHINA
WTL	 Wipro Technologies, Doddakannelli, Sarjapur Road. Bangalore, India
WTM	 Watertech S.r.l., Strada dell"Antica Fornace, 2/4, 14053 Canelli (At) Italy
WZG	 Neumann & Co. Wasserzähler Glaubitz GmbH, Industriestraße A7, 01612 Glaubitz, Germany / Deutschland
WZT	 Wizit Co Ltd, Ansin-City Gyeonggi-Do, S Korea
XAO	 Info Solution SpA, Via della Burrona, 51, Vimodrone (MI), Italy
XEM	 XEMTEC AG, Sarnen, Switzerland
XJM	 XJ Metering Co., Ltd, No 416, Ruixiang Road, Xuchang, Henan, China
XMA	 XMASTER s.c. ul. Gersona 41, Wroclaw, Poland
XMX	 Xemex NV, B-2900 Schoten, Belgium
XTR	 HENAN SUNTRONT TECH CO., LTD, No.19 Guohuai Street, High and New Tech Industrial Development Zone, Zhengzhou City, Henan Province, China
XTY	 LianYuanGang Tengyue Electronics & Technology Co.LianYunGang.Jiangsu.china Haizhou, LianYunGang, China
YDD	 Jilin Yongda Group Co., Ltd
YHE	 Youho Electric Co Ltd, Yangjoo, South Korea
YSS	 Yellowstone Soft, Brunnenstr. 32, 89584 Ehingen, Germany
YTE	 Yuksek Teknoloji, Turkey
ZAG	 Zellweger Uster AG
ZAP	 Zaptronix
ZEL	 Dr. techn. Josef Zelisko GmbH, Beethovengasse 43 45A-2340 Mödling, Austria
ZIV	 ZIV Aplicaciones y Tecnologia, S.A.
ZJY	 Zhejiang Jiayou Thermal Technology Equipment Co., LTD, Houwan Industrial Point,Yucheng Street,Yuhuan County, Taizhou, China
ZPA	 ZPA Smart Energy a.s., Komenského 821, CZ-541 01 TrutnovCzech Republic
ZRI	 ZENNER International GmbH & Co. KG, Postfach 10 33 39D-66033 Saarbrücken, Germany
ZRM	 ZENNER International GmbH & Co. KG, Postfach 10 33 39D-66033 Saarbrücken, Germany
ZTY	 Hangzhou Chint Meter Technology Co., Ltd, 7th Floor, New Building, No 313, Tianmushan Road, Hangzhou 310013, China